11111111
1E000001
10C00001
10000001
10000001
10000001
100000P1
11111111