111111111111
100000000001
10C000000001
100000000001
100000000001
100000000001
100000111111
100010000001
100011100001
100000100001
1E00001000P1
111111111111