111111
1E0001
100C01
100001
1000P1
111111