1111111111
1E00000001
10C0000001
1000000001
1000000001
1000000001
1000000001
1000000001
10000000P1
1111111111